1111111111111111111111111111111111
1E00000000000000000000000000000001
1010010100100000101001000000010101
1010010010101010001001000000010101
11000000110000000000C0000000000P01
1111111111111111111111111111111111
